XXXXX XXXXXXXXXXXXXXXXXXXXXXXXXXXXXXXXXXX
X   X X               X                 X
X X X X XXXXXXXXX XXX X XXXXXXXXXXX XXX X
X X X           X   X X X   X     X X X X
X X XXXXXXXXXXX XXX X X X X XXXXX X X X X
X X         X X X X X X X X       X X   X
X XXXXXXXXX X X X X X X X XXXXXXX X XXX X
X       X X X     X X X X X     X X   X X
X XXXXX X X XXXXXXX XXX X X X X X XXX XXX
X   X   X X       X     X X X X X   X   X
XXX X XXX XXXXXXX X XXXXX X X X XXX XXX X
X   X X         X X X X   X X X X X X X X
X XXX X XXXXX XXX X X X X X X X X X X X X
X X X X X   X   X X X X X X X X   X X X X
X X X X X XXXXX X X X X X XXX X XXX X X X
X X X X X     X X X X X X   X X X   X X X
X X X X XXXXX X X X X X XXX X X X XXX X X
X   X X       X X X X X X X X X X X   X X
XXXXX XXXXXXX X X X X X X X X XXX X X X X
X     X     X X X X X X X X X     X X X X
X XXXXXXX XXX X X X X X X X XXX XXX XXX X
X       X     X X X X     X   X   X   X X
X XXXXX XXXXXXX X X XXXXXXXXX XXX XXX X X
X X   X X     X   X           X       X X
X XXX X X XXX X XXXXXXXXXXXXXXXXXXXXXXX X
X     X   X X X                         X
XXXXXXXXX X X XXXXXXXXXXXXXXXXXXXXXXXXX X
X       X   X   X       X       X     X X
X XXXXX XXX XXX X XXXXX X XXXXX X XXX X X
X X   X X   X X X   X X X     X X X X X X
X X X X X XXX X X X X X XXXXXXX X X X X X
X X X   X     X X X X           X X X X X
X XXXXX XXXXXXX XXX XXXXXXXXXXX X X X X X
X     X         X   X     X   X X X X   X
X XXX XXXXXXXXXXX X X XXX X X X X X XXXXX
X X X X           X X X X X X X X X     X
X X X XXXXXXX XXXXXXX X X X XXX X X XXXXX
X X X       X           X X     X X     X
X X XXXXXXX XXXXXXXXXXX X XXXXXXX XXXXX X
X         X           X X               X
XXXXXXXXXXXXXXXXXXXXX XXXXXXXXXXXXXXXXXXX