XXXXXXXXXXXXXXXXXXXX XXXXXXXXXX
X                             X
X                             X
X                             X
X                             X
X                             X
X                             X
X                             X
X                             X
X                             X
X                             X
X                             X
X                             X
X                             X
X                             X
X                             X
X                             X
X                             X
X                             X
X                             X
X                             X
X                             X
X                             X
X                             X
X                             X
X                             X
X                             X
X                             X
X                             X
X                             X
XXXXXXXXXXXXX XXXXXXXXXXXXXXXXX